3
0 0 2 0 0 
0 2 2 2 0 
2 2 3 2 2 
0 2 2 2 0 
0 0 2 0 0 
3
0 0 2 6 0 
0 1 1 1 0 
6 1 1 2 0 
3 1 1 0 0 
0 2 1 3 0 
4
0 2 1 1 0 
0 1 1 0 0 
1 1 3 0 2 
4 1 1 1 5 
1 1 0 4 0 
5
0 2 1 4 0 
6 1 1 0 0 
1 1 3 1 1
4 1 1 5 0 
0 2 0 0 0 
4
0 2 1 4 0 
0 1 1 0 0 
1 1 3 1 1
4 1 1 5 0 
0 1 0 0 0 
